//MAP CONVERTED BY dmm2tgm.py THIS HEADER COMMENT PREVENTS RECONVERSION, DO NOT REMOVE
"a" = (
/turf/closed/mineral/random,
/area/ruin/unpowered/no_grav)
"b" = (
/obj/structure/cable,
/obj/structure/lattice/catwalk/over/plated/plasteel/dark,
/turf/open/floor/plating,
/area/ruin/space/has_grav/listeningstation)
"c" = (
/obj/structure/table,
/obj/item/storage/toolbox/syndicate{
	pixel_y = 6
	},
/obj/item/flashlight{
	pixel_y = 3
	},
/turf/open/floor/plasteel/dark/edge,
/area/ruin/space/has_grav/listeningstation)
"d" = (
/obj/machinery/door/airlock{
	name = "Medbay"
	},
/turf/open/floor/plasteel/textured,
/area/ruin/space/has_grav/listeningstation)
"e" = (
/obj/item/bombcore/badmin{
	anchored = 1;
	invisibility = 100
	},
/turf/closed/wall/mineral/plastitanium/nodiagonal,
/area/ruin/space/has_grav/listeningstation)
"f" = (
/obj/machinery/iv_drip,
/obj/effect/turf_decal/tile/green/half/contrast{
	dir = 4
	},
/turf/open/floor/plasteel,
/area/ruin/space/has_grav/listeningstation)
"g" = (
/obj/effect/turf_decal/siding/thinplating/dark,
/obj/effect/turf_decal/stripes/red/line,
/obj/structure/cable,
/turf/open/floor/mineral/plastitanium,
/area/ruin/space/has_grav/listeningstation)
"h" = (
/obj/effect/turf_decal/trimline/red/corner{
	dir = 8
	},
/turf/open/floor/plasteel/dark/anticorner{
	dir = 4
	},
/area/ruin/space/has_grav/listeningstation)
"i" = (
/obj/structure/tank_dispenser/oxygen{
	oxygentanks = 4
	},
/obj/effect/turf_decal/siding/thinplating/dark{
	dir = 8
	},
/obj/structure/cable,
/turf/open/floor/mineral/plastitanium/red,
/area/ruin/space/has_grav/listeningstation)
"j" = (
/obj/structure/lattice/catwalk/over/plated,
/obj/structure/railing{
	dir = 4
	},
/obj/machinery/door/firedoor,
/turf/open/floor/plating,
/area/ruin/space/has_grav/listeningstation)
"k" = (
/obj/effect/turf_decal/siding/thinplating/dark{
	dir = 8
	},
/obj/structure/rack{
	dir = 8
	},
/obj/item/mining_scanner{
	pixel_x = 5
	},
/obj/item/clothing/mask/gas{
	pixel_x = -3;
	pixel_y = 3
	},
/obj/item/clothing/mask/gas,
/obj/item/pickaxe,
/turf/open/floor/mineral/plastitanium/red,
/area/ruin/space/has_grav/listeningstation)
"l" = (
/turf/open/floor/plating/asteroid/airless,
/area/ruin/unpowered/no_grav)
"m" = (
/obj/machinery/vending/snack/random{
	extended_inventory = 1
	},
/obj/effect/turf_decal/siding/wood{
	dir = 4
	},
/obj/structure/sign/poster/contraband/random{
	pixel_x = -32
	},
/turf/open/floor/wood,
/area/ruin/space/has_grav/listeningstation)
"n" = (
/obj/structure/cable,
/obj/effect/turf_decal/sand/plating,
/turf/open/floor/plating/airless,
/area/ruin/unpowered/no_grav)
"o" = (
/obj/effect/turf_decal/trimline/red/corner{
	dir = 4
	},
/turf/open/floor/plasteel/dark/anticorner{
	dir = 8
	},
/area/ruin/space/has_grav/listeningstation)
"p" = (
/turf/closed/wall/mineral/plastitanium/nodiagonal,
/area/ruin/space/has_grav/listeningstation)
"q" = (
/turf/template_noop,
/area/template_noop)
"r" = (
/obj/structure/closet/secure_closet/medical1{
	req_access = null;
	req_access_txt = "150"
	},
/obj/effect/turf_decal/trimline/green/filled/warning{
	dir = 1
	},
/obj/effect/turf_decal/siding/green{
	dir = 1
	},
/turf/open/floor/plasteel/dark,
/area/ruin/space/has_grav/listeningstation)
"s" = (
/obj/structure/cable,
/obj/machinery/door/airlock/hatch{
	name = "E.V.A. Equipment"
	},
/obj/effect/mapping_helpers/airlock/access/all/syndicate/general,
/turf/open/floor/plasteel/dark/textured,
/area/ruin/space/has_grav/listeningstation)
"t" = (
/obj/structure/closet/crate/freezer,
/obj/item/reagent_containers/blood/o_minus{
	pixel_x = -3;
	pixel_y = 3
	},
/obj/item/reagent_containers/blood/o_minus,
/obj/effect/turf_decal/trimline/green/filled/warning{
	dir = 1
	},
/obj/effect/turf_decal/siding/green{
	dir = 1
	},
/turf/open/floor/plasteel/dark,
/area/ruin/space/has_grav/listeningstation)
"u" = (
/obj/structure/table,
/obj/machinery/cell_charger,
/obj/item/stack/cable_coil{
	pixel_y = 8
	},
/obj/item/stock_parts/cell/high/plus,
/turf/open/floor/plasteel/dark/edge,
/area/ruin/space/has_grav/listeningstation)
"v" = (
/turf/open/floor/plasteel,
/area/ruin/space/has_grav/listeningstation)
"w" = (
/obj/effect/spawner/structure/window/plasma/reinforced/plastitanium,
/obj/structure/cable,
/turf/open/floor/plating,
/area/ruin/space/has_grav/listeningstation)
"x" = (
/obj/structure/sink{
	dir = 4;
	pixel_x = -12
	},
/obj/effect/turf_decal/tile/green/half/contrast{
	dir = 8
	},
/turf/open/floor/plasteel,
/area/ruin/space/has_grav/listeningstation)
"y" = (
/obj/docking_port/stationary{
	dir = 4;
	dwidth = 4;
	height = 5;
	id = "caravansyndicate1_listeningpost";
	name = "Syndicate Listening Post";
	width = 9
	},
/turf/template_noop,
/area/template_noop)
"z" = (
/obj/effect/spawner/structure/window/plasma/reinforced/plastitanium,
/obj/structure/cable,
/turf/open/floor/plating,
/area/ruin/unpowered/no_grav)
"A" = (
/obj/structure/rack,
/obj/item/storage/firstaid/regular,
/obj/item/clothing/neck/stethoscope,
/obj/effect/turf_decal/trimline/green/filled/warning{
	dir = 1
	},
/obj/effect/turf_decal/siding/green{
	dir = 1
	},
/turf/open/floor/plasteel/dark,
/area/ruin/space/has_grav/listeningstation)
"B" = (
/obj/effect/turf_decal/sand/plating,
/obj/effect/turf_decal/stripes/asteroid/line{
	dir = 1
	},
/obj/structure/cable,
/turf/open/floor/plating/airless,
/area/ruin/unpowered/no_grav)
"C" = (
/obj/machinery/door/window/brigdoor{
	req_access_txt = "150"
	},
/obj/machinery/syndicatebomb/self_destruct{
	anchored = 1
	},
/obj/structure/sign/warning/explosives{
	pixel_y = 32
	},
/obj/effect/turf_decal/siding/thinplating/dark,
/turf/open/floor/circuit/red,
/area/ruin/space/has_grav/listeningstation)
"D" = (
/obj/structure/cable,
/turf/open/floor/plating/asteroid/airless,
/area/ruin/unpowered/no_grav)
"F" = (
/obj/structure/lattice/catwalk/over/plated,
/obj/structure/railing{
	dir = 8
	},
/obj/machinery/door/firedoor,
/turf/open/floor/plating,
/area/ruin/space/has_grav/listeningstation)
"G" = (
/turf/open/floor/plasteel/dark,
/area/ruin/space/has_grav/listeningstation)
"H" = (
/obj/structure/bed,
/obj/effect/turf_decal/trimline/green/filled/warning{
	dir = 8
	},
/turf/open/floor/plasteel,
/area/ruin/space/has_grav/listeningstation)
"I" = (
/obj/machinery/door/airlock/external{
	id_tag = "syndie_listeningpost_external"
	},
/obj/effect/mapping_helpers/airlock/access/all/syndicate/general,
/obj/effect/mapping_helpers/airlock/cyclelink_helper,
/obj/effect/turf_decal/stripes/line,
/obj/effect/turf_decal/stripes/asteroid/line{
	dir = 1
	},
/obj/structure/cable,
/turf/open/floor/plating,
/area/ruin/space/has_grav/listeningstation)
"J" = (
/obj/effect/turf_decal/sand/plating,
/obj/effect/turf_decal/stripes/asteroid/line{
	dir = 5
	},
/turf/open/floor/plating/airless,
/area/ruin/unpowered/no_grav)
"K" = (
/obj/structure/cable,
/turf/open/floor/plasteel/dark,
/area/ruin/space/has_grav/listeningstation)
"L" = (
/obj/structure/flora/rock,
/turf/open/floor/plating/asteroid/airless,
/area/ruin/unpowered/no_grav)
"N" = (
/obj/structure/closet/emcloset/anchored,
/turf/open/floor/plasteel/dark,
/area/ruin/space/has_grav/listeningstation)
"O" = (
/obj/structure/sign/departments/medbay/alt{
	pixel_y = -32
	},
/obj/effect/turf_decal/trimline/red/corner{
	dir = 1
	},
/turf/open/floor/plasteel/dark/anticorner,
/area/ruin/space/has_grav/listeningstation)
"P" = (
/obj/machinery/computer/security/telescreen/entertainment{
	pixel_y = 32
	},
/turf/open/floor/plasteel/dark,
/area/ruin/space/has_grav/listeningstation)
"Q" = (
/obj/machinery/vending/cola/random{
	extended_inventory = 1
	},
/obj/effect/turf_decal/siding/wood{
	dir = 6
	},
/turf/open/floor/wood,
/area/ruin/space/has_grav/listeningstation)
"R" = (
/obj/effect/turf_decal/sand/plating,
/obj/effect/turf_decal/stripes/asteroid/line{
	dir = 9
	},
/obj/structure/sign/warning/securearea{
	pixel_y = -32
	},
/turf/open/floor/plating/airless,
/area/ruin/unpowered/no_grav)
"S" = (
/turf/open/floor/plasteel/dark/textured,
/area/ruin/space/has_grav/listeningstation)
"T" = (
/obj/effect/turf_decal/trimline/red/corner,
/turf/open/floor/plasteel/dark/anticorner{
	dir = 1
	},
/area/ruin/space/has_grav/listeningstation)
"V" = (
/obj/effect/turf_decal/siding/thinplating/dark,
/obj/effect/turf_decal/stripes/red/line,
/obj/structure/chair/comfy/shuttle,
/obj/structure/sign/warning/vacuum/external{
	pixel_y = 32
	},
/turf/open/floor/mineral/plastitanium,
/area/ruin/space/has_grav/listeningstation)
"W" = (
/obj/effect/turf_decal/siding/thinplating/dark,
/obj/effect/turf_decal/stripes/red/line,
/obj/machinery/suit_storage_unit/open,
/obj/structure/railing{
	dir = 4
	},
/turf/open/floor/mineral/plastitanium,
/area/ruin/space/has_grav/listeningstation)
"X" = (
/obj/machinery/door/airlock/external{
	id_tag = "syndie_listeningpost_external"
	},
/obj/effect/mapping_helpers/airlock/access/all/syndicate/general,
/obj/effect/mapping_helpers/airlock/cyclelink_helper{
	dir = 1
	},
/obj/effect/turf_decal/stripes/line{
	icon_state = "warningline";
	dir = 1
	},
/obj/effect/turf_decal/siding/wideplating_new/dark,
/obj/structure/cable,
/turf/open/floor/plating,
/area/ruin/space/has_grav/listeningstation)
"Y" = (
/turf/open/floor/plasteel/dark/edge,
/area/ruin/space/has_grav/listeningstation)
"Z" = (
/obj/structure/lattice/catwalk/over,
/obj/structure/cable,
/turf/open/floor/plating,
/area/ruin/space/has_grav/listeningstation)

(1,1,1) = {"
q
q
q
q
q
q
q
q
q
q
q
q
q
q
q
q
a
a
a
a
a
q
q
q
q
q
q
q
q
q
q
q
q
q
q
q
q
q
"}
(2,1,1) = {"
q
q
q
q
q
q
a
a
a
a
a
q
q
q
a
a
a
a
a
a
a
a
a
a
a
q
q
q
q
q
q
q
q
q
q
q
q
q
"}
(3,1,1) = {"
q
q
q
q
q
a
a
a
a
a
a
a
q
a
a
a
a
a
a
a
a
a
a
a
a
a
a
a
a
a
q
a
a
a
q
q
q
q
"}
(4,1,1) = {"
q
q
q
q
a
a
a
a
a
a
a
a
a
a
a
a
a
a
a
a
a
a
a
a
a
a
a
a
a
a
a
a
a
a
a
q
q
q
"}
(5,1,1) = {"
q
q
q
a
a
a
a
a
a
a
a
a
a
a
a
a
a
a
a
a
a
a
a
a
a
a
a
a
a
a
a
a
a
a
a
q
q
q
"}
(6,1,1) = {"
q
q
q
a
a
a
a
a
a
a
a
a
a
a
a
a
a
a
a
a
a
a
a
a
a
a
a
a
a
a
a
a
a
a
a
a
a
q
"}
(7,1,1) = {"
q
q
a
a
a
a
a
a
a
a
a
a
a
a
a
a
a
a
a
a
a
a
a
a
a
a
a
a
a
a
a
a
a
a
a
a
a
q
"}
(8,1,1) = {"
q
q
a
a
a
a
a
a
a
a
a
a
a
a
a
a
a
a
a
a
a
a
a
a
a
a
a
a
a
a
a
a
a
a
a
a
a
q
"}
(9,1,1) = {"
q
q
a
a
a
a
a
a
a
a
a
a
a
a
a
a
a
a
a
a
a
a
a
a
a
a
a
a
a
a
a
a
a
a
a
a
a
q
"}
(10,1,1) = {"
q
q
q
a
a
a
a
a
a
a
a
a
a
a
a
a
a
a
a
a
a
a
a
a
a
a
a
a
a
a
a
a
a
a
a
a
a
q
"}
(11,1,1) = {"
q
q
q
a
a
a
a
a
a
a
a
a
a
a
a
a
a
a
a
a
a
a
a
a
a
a
a
a
a
a
a
a
a
a
a
a
q
q
"}
(12,1,1) = {"
q
q
q
a
a
a
a
a
a
a
a
a
a
a
a
a
a
a
a
a
a
a
a
a
a
a
a
a
a
a
a
a
a
a
a
a
q
q
"}
(13,1,1) = {"
q
q
q
a
a
a
a
a
a
a
a
a
a
a
a
a
a
a
a
a
a
a
a
a
a
a
a
a
a
a
a
a
a
a
a
a
a
q
"}
(14,1,1) = {"
q
q
q
a
a
a
a
a
a
a
a
a
a
a
a
a
a
a
a
a
a
a
a
a
a
a
a
a
a
a
a
a
a
a
a
a
a
q
"}
(15,1,1) = {"
q
q
q
a
a
a
a
a
a
a
a
a
a
a
a
a
a
a
a
a
a
a
a
a
a
a
a
a
a
a
a
a
a
a
a
a
a
q
"}
(16,1,1) = {"
q
q
q
a
a
a
a
a
a
a
a
a
a
a
a
p
p
p
S
p
a
a
a
a
a
a
a
a
a
a
a
a
a
a
a
a
a
q
"}
(17,1,1) = {"
q
q
a
a
a
a
a
a
a
a
a
a
a
a
p
p
m
Q
G
p
p
p
p
a
a
a
a
a
a
a
a
a
a
a
a
a
a
q
"}
(18,1,1) = {"
q
a
a
a
a
a
a
a
a
a
a
a
a
a
p
C
T
G
o
p
x
r
p
a
a
a
a
a
a
a
a
a
a
a
a
a
a
q
"}
(19,1,1) = {"
q
a
a
a
a
a
a
a
a
a
a
a
a
a
p
p
P
G
G
d
v
t
p
a
a
a
a
a
a
a
a
a
a
a
a
a
a
q
"}
(20,1,1) = {"
a
a
a
a
a
a
a
a
a
a
a
a
a
a
a
S
h
G
O
p
f
A
p
a
a
a
a
a
a
a
a
a
a
a
a
a
a
a
"}
(21,1,1) = {"
a
a
a
a
a
a
a
a
a
a
a
a
a
a
z
p
e
N
G
p
H
p
p
a
a
a
a
a
a
a
a
a
a
a
a
a
a
a
"}
(22,1,1) = {"
a
a
a
a
a
a
a
a
a
a
a
a
a
a
a
a
p
p
s
p
p
p
a
a
a
a
a
a
a
a
a
a
a
a
a
a
a
a
"}
(23,1,1) = {"
q
a
a
a
a
a
a
a
a
a
a
a
a
R
p
j
p
W
K
u
p
p
a
a
a
a
a
a
a
a
a
a
a
a
a
a
a
a
"}
(24,1,1) = {"
q
a
a
a
a
a
a
a
a
a
a
D
D
B
I
Z
X
g
b
c
p
a
a
a
a
a
a
a
a
a
a
a
a
a
a
a
a
a
"}
(25,1,1) = {"
q
a
a
a
a
a
a
a
a
a
n
D
a
J
p
F
p
V
K
Y
p
a
a
a
a
a
a
a
a
a
a
a
a
a
a
a
a
q
"}
(26,1,1) = {"
q
a
a
a
a
a
a
a
a
L
n
a
a
a
a
a
p
p
i
k
p
a
a
a
a
a
a
a
a
a
a
a
a
q
q
q
q
q
"}
(27,1,1) = {"
q
q
a
a
a
a
a
a
a
a
D
a
a
a
a
a
a
p
w
w
p
a
a
a
a
a
a
a
a
a
a
a
q
q
q
q
q
q
"}
(28,1,1) = {"
q
q
q
q
a
a
a
a
a
a
D
D
a
a
a
a
a
a
a
a
a
a
a
a
a
a
a
a
a
a
a
q
q
q
q
q
q
q
"}
(29,1,1) = {"
q
q
q
q
q
a
a
a
a
a
a
n
a
a
a
a
a
a
a
a
a
a
a
a
a
a
a
a
a
q
q
q
q
q
q
q
q
q
"}
(30,1,1) = {"
q
q
q
q
q
a
a
a
a
a
l
n
a
a
a
a
a
a
a
a
a
a
a
a
a
a
q
q
q
q
q
q
q
q
q
q
q
q
"}
(31,1,1) = {"
q
q
q
q
q
q
q
q
a
l
l
D
l
l
a
a
a
a
a
a
a
a
a
a
a
a
q
q
q
q
q
q
q
q
q
q
q
q
"}
(32,1,1) = {"
q
q
q
q
q
q
q
q
q
q
q
y
q
q
q
q
q
q
q
a
a
a
a
a
q
q
q
q
q
q
q
q
q
q
q
q
q
q
"}
