//MAP CONVERTED BY dmm2tgm.py THIS HEADER COMMENT PREVENTS RECONVERSION, DO NOT REMOVE
"aa" = (
/turf/template_noop,
/area/template_noop)
"ab" = (
/obj/machinery/porta_turret/syndicate/shuttle{
	dir = 9
	},
/turf/closed/wall/r_wall/syndicate,
/area/shuttle/syndicate/bridge)
"ac" = (
/turf/closed/wall/r_wall/syndicate,
/area/shuttle/syndicate/bridge)
"ad" = (
/obj/machinery/porta_turret/syndicate/shuttle{
	dir = 10
	},
/turf/closed/wall/r_wall/syndicate,
/area/shuttle/syndicate/bridge)
"ae" = (
/obj/machinery/door/poddoor/shutters{
	id = "syndieshutters";
	name = "blast shutters"
	},
/obj/effect/spawner/structure/window/plasma/reinforced/plastitanium,
/turf/open/floor/plating,
/area/shuttle/syndicate/bridge)
"af" = (
/turf/closed/wall/r_wall/syndicate,
/area/shuttle/syndicate/hallway)
"ag" = (
/obj/structure/table/reinforced,
/obj/effect/turf_decal/tile/red{
	dir = 8
	},
/obj/item/storage/box/handcuffs{
	pixel_x = 3;
	pixel_y = 3
	},
/obj/item/storage/box/zipties,
/turf/open/floor/plasteel/dark,
/area/shuttle/syndicate/bridge)
"ah" = (
/obj/structure/table/reinforced,
/obj/effect/turf_decal/tile/red{
	dir = 4
	},
/obj/item/stack/cable_coil,
/obj/item/stack/cable_coil,
/obj/item/crowbar/red,
/turf/open/floor/plasteel/dark,
/area/shuttle/syndicate/bridge)
"ai" = (
/obj/machinery/computer/camera_advanced/shuttle_docker/syndicate{
	dir = 4
	},
/obj/effect/turf_decal/tile/dark/whole/constrast,
/obj/effect/turf_decal/siding/thinplating/dark{
	dir = 10
	},
/turf/open/floor/plasteel/dark,
/area/shuttle/syndicate/bridge)
"aj" = (
/obj/structure/chair/office{
	name = "tactical swivel chair"
	},
/obj/effect/turf_decal/tile/dark/whole/constrast,
/obj/effect/turf_decal/siding/thinplating/dark,
/turf/open/floor/plasteel/dark,
/area/shuttle/syndicate/bridge)
"ak" = (
/obj/machinery/computer/shuttle/syndicate{
	dir = 8
	},
/obj/effect/turf_decal/tile/dark/whole/constrast,
/obj/effect/turf_decal/siding/thinplating/dark{
	dir = 6
	},
/turf/open/floor/plasteel/dark,
/area/shuttle/syndicate/bridge)
"al" = (
/obj/structure/table/reinforced,
/obj/item/clipboard,
/obj/item/folder/red,
/obj/item/toy/figure/syndie{
	pixel_x = 12;
	pixel_y = 6
	},
/obj/effect/turf_decal/tile/red{
	dir = 1
	},
/turf/open/floor/plasteel/dark,
/area/shuttle/syndicate/bridge)
"am" = (
/obj/structure/table/reinforced,
/obj/item/storage/fancy/donut_box{
	pixel_y = 8
	},
/obj/effect/turf_decal/tile/red,
/turf/open/floor/plasteel/dark,
/area/shuttle/syndicate/bridge)
"an" = (
/obj/machinery/status_display/evac{
	pixel_x = -32
	},
/obj/machinery/light{
	dir = 8
	},
/obj/machinery/computer/crew/syndie{
	dir = 4
	},
/obj/effect/turf_decal/tile/red{
	dir = 8
	},
/turf/open/floor/plasteel/dark,
/area/shuttle/syndicate/bridge)
"ao" = (
/obj/structure/chair/office{
	dir = 8;
	name = "tactical swivel chair"
	},
/obj/effect/turf_decal/tile/red,
/turf/open/floor/plasteel/mil/red{
	dir = 9
	},
/area/shuttle/syndicate/bridge)
"ap" = (
/obj/effect/turf_decal/tile/red,
/turf/open/floor/plasteel/mil/red{
	dir = 9
	},
/area/shuttle/syndicate/bridge)
"aq" = (
/obj/effect/turf_decal/tile/bar/diagonal,
/obj/effect/turf_decal/tile/dark/diagonal{
	dir = 4
	},
/obj/effect/turf_decal/siding/thinplating/dark/end{
	dir = 1
	},
/turf/open/floor/circuit/red,
/area/shuttle/syndicate/bridge)
"ar" = (
/obj/structure/chair/office{
	dir = 4;
	name = "tactical swivel chair"
	},
/obj/effect/turf_decal/tile/red{
	dir = 8
	},
/turf/open/floor/plasteel/mil/red{
	dir = 5
	},
/area/shuttle/syndicate/bridge)
"as" = (
/obj/machinery/status_display/ai{
	pixel_x = 32
	},
/obj/machinery/light{
	dir = 4
	},
/obj/machinery/computer/camera_advanced/syndie{
	dir = 8
	},
/obj/effect/turf_decal/tile/red,
/turf/open/floor/plasteel/dark,
/area/shuttle/syndicate/bridge)
"at" = (
/obj/machinery/computer/med_data/syndie{
	dir = 4
	},
/obj/effect/turf_decal/tile/red{
	dir = 8
	},
/turf/open/floor/plasteel/dark,
/area/shuttle/syndicate/bridge)
"au" = (
/obj/effect/turf_decal/tile/red{
	dir = 1
	},
/turf/open/floor/plasteel/mil/red{
	dir = 6
	},
/area/shuttle/syndicate/bridge)
"av" = (
/obj/effect/turf_decal/tile/red/half/contrast{
	dir = 1
	},
/turf/open/floor/plasteel/dark,
/area/shuttle/syndicate/bridge)
"aw" = (
/obj/machinery/porta_turret/syndicate/shuttle{
	dir = 9
	},
/turf/closed/wall/r_wall/syndicate,
/area/shuttle/syndicate/eva)
"ax" = (
/turf/closed/wall/r_wall/syndicate,
/area/shuttle/syndicate/eva)
"ay" = (
/obj/effect/turf_decal/siding/thinplating/dark,
/obj/machinery/suit_storage_unit/open,
/obj/item/clothing/suit/space/syndicate,
/obj/item/clothing/head/helmet/space/syndicate,
/turf/open/floor/mineral/plastitanium,
/area/shuttle/syndicate/eva)
"az" = (
/obj/effect/turf_decal/syndicateemblem/top/left,
/turf/open/floor/mineral/plastitanium/red,
/area/shuttle/syndicate/hallway)
"aA" = (
/turf/closed/wall/r_wall/syndicate/nodiagonal,
/area/shuttle/syndicate/eva)
"aB" = (
/turf/closed/wall/r_wall/syndicate,
/area/shuttle/syndicate/airlock)
"aC" = (
/obj/structure/chair/comfy/shuttle{
	dir = 4;
	name = "tactical chair"
	},
/turf/open/floor/plasteel/dark,
/area/shuttle/syndicate/hallway)
"aD" = (
/turf/open/floor/plasteel/dark,
/area/shuttle/syndicate/hallway)
"aE" = (
/obj/structure/chair/comfy/shuttle{
	dir = 8;
	name = "tactical chair"
	},
/turf/open/floor/plasteel/dark,
/area/shuttle/syndicate/hallway)
"aF" = (
/obj/machinery/porta_turret/syndicate/shuttle{
	dir = 5
	},
/turf/closed/wall/r_wall/syndicate,
/area/shuttle/syndicate/armory)
"aG" = (
/obj/machinery/porta_turret/syndicate/shuttle{
	dir = 9
	},
/turf/closed/wall/r_wall/syndicate,
/area/shuttle/syndicate/medical)
"aH" = (
/obj/structure/chair/comfy/shuttle{
	dir = 4;
	name = "tactical chair"
	},
/obj/machinery/light{
	dir = 8
	},
/turf/open/floor/plasteel/dark,
/area/shuttle/syndicate/hallway)
"aI" = (
/obj/structure/chair/comfy/shuttle{
	dir = 8;
	name = "tactical chair"
	},
/obj/machinery/light{
	dir = 4
	},
/turf/open/floor/plasteel/dark,
/area/shuttle/syndicate/hallway)
"aJ" = (
/turf/closed/wall/r_wall/syndicate,
/area/shuttle/syndicate/medical)
"aK" = (
/turf/closed/wall/r_wall/syndicate/nodiagonal,
/area/shuttle/syndicate/medical)
"aL" = (
/obj/machinery/suit_storage_unit/syndicate,
/turf/open/floor/mineral/plastitanium,
/area/shuttle/syndicate/eva)
"aM" = (
/obj/machinery/portable_atmospherics/canister/oxygen,
/obj/effect/turf_decal/siding/thinplating/dark{
	dir = 6
	},
/obj/structure/window/reinforced/survival_pod{
	dir = 4
	},
/obj/structure/window/reinforced/survival_pod{
	dir = 6
	},
/turf/open/floor/mineral/plastitanium,
/area/shuttle/syndicate/eva)
"aN" = (
/obj/machinery/firealarm{
	pixel_y = 26
	},
/obj/effect/turf_decal/tile/red{
	dir = 4
	},
/obj/structure/reagent_dispensers/fueltank,
/turf/open/floor/plasteel/dark,
/area/shuttle/syndicate/eva)
"aO" = (
/obj/machinery/firealarm{
	pixel_y = 26
	},
/obj/effect/turf_decal/tile/brown{
	dir = 4
	},
/turf/open/floor/plasteel/dark,
/area/shuttle/syndicate/airlock)
"aP" = (
/obj/effect/turf_decal/bot_red/left,
/obj/structure/rack,
/turf/open/floor/plasteel/dark,
/area/shuttle/syndicate/airlock)
"aQ" = (
/obj/effect/turf_decal/tile/brown{
	dir = 4
	},
/turf/open/floor/plasteel/dark,
/area/shuttle/syndicate/airlock)
"aR" = (
/obj/machinery/suit_storage_unit/syndicate,
/obj/effect/turf_decal/siding/thinplating/dark{
	dir = 1
	},
/turf/open/floor/mineral/plastitanium,
/area/shuttle/syndicate/eva)
"aS" = (
/obj/effect/turf_decal/tile/red{
	dir = 4
	},
/turf/open/floor/plasteel/dark,
/area/shuttle/syndicate/eva)
"aT" = (
/obj/effect/turf_decal/bot_red/left,
/obj/structure/closet/crate,
/obj/item/clothing/under/syndicate/skirt,
/obj/item/clothing/under/syndicate/skirt,
/obj/item/clothing/under/syndicate/skirt,
/obj/item/clothing/under/syndicate/combat,
/obj/item/clothing/under/syndicate/combat,
/obj/item/clothing/under/syndicate/combat,
/turf/open/floor/plasteel/dark,
/area/shuttle/syndicate/airlock)
"aU" = (
/obj/machinery/light{
	dir = 4
	},
/obj/effect/turf_decal/tile/red{
	dir = 4
	},
/turf/open/floor/plasteel/dark,
/area/shuttle/syndicate/eva)
"aV" = (
/obj/effect/spawner/structure/window/plasma/reinforced/plastitanium,
/turf/open/floor/plating,
/area/shuttle/syndicate/hallway)
"aW" = (
/obj/machinery/door/airlock/grunge{
	name = "Ready Room";
	req_access_txt = "150"
	},
/turf/open/floor/plasteel/dark,
/area/shuttle/syndicate/hallway)
"aX" = (
/obj/machinery/light{
	dir = 8
	},
/turf/open/floor/plasteel/dark,
/area/shuttle/syndicate/airlock)
"aY" = (
/obj/machinery/door/poddoor{
	id = "smindicate";
	name = "outer blast door"
	},
/obj/docking_port/mobile{
	dheight = 1;
	dir = 8;
	dwidth = 12;
	height = 17;
	hidden = 1;
	id = "syndicate";
	movement_force = list("KNOCKDOWN"=0,"THROW"=0);
	name = "syndicate infiltrator";
	port_direction = 4;
	width = 23
	},
/obj/structure/fans/tiny,
/turf/open/floor/plating,
/area/shuttle/syndicate/airlock)
"aZ" = (
/turf/open/floor/plasteel/dark,
/area/shuttle/syndicate/eva)
"ba" = (
/obj/machinery/door/airlock/hatch{
	req_access_txt = "150";
	name = "EVA Gear"
	},
/turf/open/floor/plasteel/dark,
/area/shuttle/syndicate/eva)
"bb" = (
/obj/machinery/door/airlock/hatch{
	req_access_txt = "150";
	name = "Cargo Bay"
	},
/turf/open/floor/plasteel/dark,
/area/shuttle/syndicate/airlock)
"bc" = (
/turf/open/floor/plasteel/dark,
/area/shuttle/syndicate/airlock)
"bd" = (
/obj/structure/sign/warning/vacuum/external{
	pixel_y = -32
	},
/obj/structure/fans/tiny,
/obj/machinery/door/poddoor{
	id = "smindicate";
	name = "outer blast door"
	},
/turf/open/floor/plating,
/area/shuttle/syndicate/airlock)
"be" = (
/obj/effect/turf_decal/siding/thinplating/dark/end{
	dir = 1
	},
/turf/open/floor/plasteel/chapel{
	dir = 1
	},
/area/shuttle/syndicate/hallway)
"bg" = (
/obj/effect/spawner/structure/window/plasma/reinforced/plastitanium,
/turf/open/floor/plating,
/area/shuttle/syndicate/eva)
"bh" = (
/obj/effect/spawner/structure/window/plasma/reinforced/plastitanium,
/turf/open/floor/plating,
/area/shuttle/syndicate/airlock)
"bi" = (
/obj/effect/turf_decal/tile/brown{
	dir = 8
	},
/turf/open/floor/plasteel/dark,
/area/shuttle/syndicate/airlock)
"bj" = (
/turf/closed/wall/r_wall/syndicate/nodiagonal,
/area/shuttle/syndicate/armory)
"bk" = (
/obj/machinery/status_display/ai,
/turf/closed/wall/r_wall/syndicate,
/area/shuttle/syndicate/medical)
"bm" = (
/turf/closed/wall/r_wall/syndicate,
/area/shuttle/syndicate/armory)
"bn" = (
/obj/machinery/status_display/evac,
/turf/closed/wall/r_wall/syndicate,
/area/shuttle/syndicate/armory)
"bo" = (
/obj/machinery/nuclearbomb/syndicate{
	anchored = 1
	},
/obj/machinery/door/window{
	dir = 1
	},
/turf/open/floor/circuit/red,
/area/shuttle/syndicate/hallway)
"bq" = (
/obj/machinery/sleeper/syndie{
	dir = 4
	},
/turf/open/floor/plasteel/dark,
/area/shuttle/syndicate/medical)
"br" = (
/turf/open/floor/plasteel/dark,
/area/shuttle/syndicate/medical)
"bs" = (
/obj/machinery/light{
	dir = 1
	},
/turf/open/floor/plasteel/dark,
/area/shuttle/syndicate/medical)
"bt" = (
/obj/item/reagent_containers/glass/bottle/epinephrine{
	pixel_x = 6
	},
/obj/item/reagent_containers/glass/bottle/multiver{
	pixel_x = -3
	},
/obj/item/reagent_containers/glass/bottle/epinephrine{
	pixel_x = -3;
	pixel_y = 8
	},
/obj/item/reagent_containers/glass/bottle/multiver{
	pixel_x = 6;
	pixel_y = 8
	},
/obj/item/reagent_containers/syringe/epinephrine{
	pixel_x = 3;
	pixel_y = -2
	},
/obj/item/reagent_containers/syringe/epinephrine{
	pixel_x = 4;
	pixel_y = 1
	},
/obj/item/reagent_containers/syringe/epinephrine{
	pixel_x = -2;
	pixel_y = 5
	},
/obj/item/reagent_containers/syringe/epinephrine{
	pixel_x = 2;
	pixel_y = 8
	},
/obj/structure/table/reinforced,
/turf/open/floor/plasteel/dark,
/area/shuttle/syndicate/medical)
"bu" = (
/obj/structure/table/reinforced,
/obj/item/stack/medical/gauze,
/obj/item/stack/medical/bruise_pack,
/obj/item/stack/medical/ointment,
/turf/open/floor/plasteel/dark,
/area/shuttle/syndicate/medical)
"bv" = (
/obj/effect/spawner/structure/window/plasma/reinforced/plastitanium,
/turf/open/floor/plating,
/area/shuttle/syndicate/medical)
"bw" = (
/obj/effect/spawner/structure/window/plasma/reinforced/plastitanium,
/turf/open/floor/plating,
/area/shuttle/syndicate/armory)
"bx" = (
/obj/item/stock_parts/cell/high{
	pixel_x = -3;
	pixel_y = 3
	},
/obj/item/stock_parts/cell/high,
/obj/structure/table/reinforced,
/turf/open/floor/plasteel/dark,
/area/shuttle/syndicate/armory)
"by" = (
/obj/item/screwdriver{
	pixel_y = 9
	},
/obj/item/assembly/voice{
	pixel_y = 3
	},
/obj/structure/table/reinforced,
/turf/open/floor/plasteel/dark,
/area/shuttle/syndicate/armory)
"bz" = (
/obj/item/wrench,
/obj/item/assembly/infra,
/obj/structure/table/reinforced,
/obj/machinery/light{
	dir = 1
	},
/turf/open/floor/plasteel/dark,
/area/shuttle/syndicate/armory)
"bA" = (
/obj/item/assembly/signaler,
/obj/item/assembly/signaler,
/obj/item/assembly/prox_sensor{
	pixel_x = -8;
	pixel_y = 4
	},
/obj/item/assembly/prox_sensor{
	pixel_x = -8;
	pixel_y = 4
	},
/obj/structure/table/reinforced,
/turf/open/floor/plasteel/dark,
/area/shuttle/syndicate/armory)
"bB" = (
/obj/item/weldingtool/largetank{
	pixel_y = 3
	},
/obj/item/multitool,
/obj/structure/table/reinforced,
/turf/open/floor/plasteel/dark,
/area/shuttle/syndicate/armory)
"bC" = (
/obj/structure/bed/roller,
/obj/machinery/iv_drip,
/turf/open/floor/plasteel/dark,
/area/shuttle/syndicate/medical)
"bD" = (
/obj/effect/turf_decal/syndicateemblem/middle/left,
/turf/open/floor/mineral/plastitanium/red,
/area/shuttle/syndicate/hallway)
"bE" = (
/obj/machinery/light{
	dir = 8
	},
/obj/effect/turf_decal/syndicateemblem/bottom/left,
/turf/open/floor/mineral/plastitanium/red,
/area/shuttle/syndicate/hallway)
"bF" = (
/obj/machinery/light{
	dir = 4
	},
/obj/effect/turf_decal/syndicateemblem/bottom/right,
/turf/open/floor/mineral/plastitanium/red,
/area/shuttle/syndicate/hallway)
"bG" = (
/turf/open/floor/plasteel/dark,
/area/shuttle/syndicate/armory)
"bH" = (
/obj/effect/turf_decal/tile/bar{
	dir = 8
	},
/turf/open/floor/plasteel/dark,
/area/shuttle/syndicate/hallway)
"bI" = (
/obj/effect/turf_decal/tile/red{
	dir = 8
	},
/turf/open/floor/plasteel/mil/red{
	dir = 5
	},
/area/shuttle/syndicate/bridge)
"bJ" = (
/obj/structure/tank_dispenser/oxygen,
/obj/effect/turf_decal/tile/red/half/contrast{
	dir = 8
	},
/turf/open/floor/plasteel/dark,
/area/shuttle/syndicate/eva)
"bK" = (
/obj/machinery/door/airlock/hatch{
	req_access_txt = "150"
	},
/turf/open/floor/plasteel/dark,
/area/shuttle/syndicate/medical)
"bL" = (
/obj/effect/turf_decal/siding/thinplating/dark,
/turf/open/floor/mineral/plastitanium/red,
/area/shuttle/syndicate/hallway)
"bM" = (
/obj/machinery/door/airlock/hatch{
	req_access_txt = "150"
	},
/turf/open/floor/plasteel/dark,
/area/shuttle/syndicate/armory)
"bN" = (
/obj/machinery/button/door{
	id = "syndieshutters";
	name = "Cockpit View Control";
	req_access_txt = "150";
	pixel_y = -26
	},
/obj/effect/turf_decal/tile/red/half/contrast{
	dir = 1
	},
/turf/open/floor/plasteel/dark,
/area/shuttle/syndicate/bridge)
"bO" = (
/obj/effect/turf_decal/tile/bar{
	dir = 4
	},
/turf/open/floor/plasteel/dark,
/area/shuttle/syndicate/hallway)
"bP" = (
/obj/structure/chair/comfy/shuttle{
	dir = 4;
	name = "tactical chair"
	},
/obj/machinery/status_display/evac{
	pixel_y = 32
	},
/turf/open/floor/plasteel/dark,
/area/shuttle/syndicate/hallway)
"bQ" = (
/obj/structure/closet/syndicate/personal,
/turf/open/floor/plasteel/dark,
/area/shuttle/syndicate/armory)
"bR" = (
/obj/structure/table/reinforced,
/obj/item/reagent_containers/glass/beaker/large,
/obj/item/reagent_containers/glass/beaker,
/obj/item/reagent_containers/dropper,
/turf/open/floor/plasteel/dark,
/area/shuttle/syndicate/medical)
"bS" = (
/obj/effect/turf_decal/siding/thinplating/dark{
	dir = 1
	},
/turf/open/floor/mineral/plastitanium/red,
/area/shuttle/syndicate/hallway)
"bT" = (
/obj/effect/turf_decal/tile/red{
	dir = 4
	},
/turf/open/floor/plasteel/mil/red{
	dir = 10
	},
/area/shuttle/syndicate/bridge)
"bU" = (
/obj/effect/turf_decal/tile/bar{
	dir = 1
	},
/turf/open/floor/plasteel/dark,
/area/shuttle/syndicate/hallway)
"bV" = (
/obj/effect/turf_decal/siding/thinplating/dark{
	dir = 4
	},
/obj/effect/turf_decal/siding/thinplating/dark{
	dir = 8
	},
/obj/machinery/door/firedoor,
/obj/structure/railing{
	dir = 4
	},
/obj/structure/railing{
	dir = 8
	},
/turf/open/floor/plasteel/elevatorshaft,
/area/shuttle/syndicate/airlock)
"bW" = (
/obj/machinery/suit_storage_unit/syndicate,
/obj/effect/turf_decal/siding/thinplating/dark{
	dir = 5
	},
/obj/structure/window/reinforced/survival_pod{
	dir = 4
	},
/obj/structure/window/reinforced/survival_pod{
	dir = 5
	},
/turf/open/floor/mineral/plastitanium,
/area/shuttle/syndicate/eva)
"bX" = (
/obj/structure/closet/syndicate/nuclear,
/turf/open/floor/plasteel/dark,
/area/shuttle/syndicate/armory)
"bY" = (
/obj/structure/window/reinforced{
	dir = 1
	},
/obj/item/bodypart/r_arm/robot,
/obj/item/bodypart/l_arm/robot,
/obj/structure/table/reinforced,
/obj/item/toy/plush/nukeplushie,
/turf/open/floor/plasteel/dark,
/area/shuttle/syndicate/medical)
"bZ" = (
/obj/machinery/door/window{
	dir = 1;
	name = "Surgery";
	req_access_txt = "150"
	},
/turf/open/floor/plasteel/dark,
/area/shuttle/syndicate/medical)
"ca" = (
/obj/structure/window/reinforced{
	dir = 1
	},
/turf/open/floor/plasteel/dark,
/area/shuttle/syndicate/medical)
"cb" = (
/obj/structure/window/reinforced{
	dir = 8
	},
/obj/item/storage/firstaid/regular{
	pixel_x = 3;
	pixel_y = 3
	},
/obj/item/storage/firstaid/brute,
/obj/item/storage/firstaid/regular{
	pixel_x = -3;
	pixel_y = -3
	},
/obj/structure/table/reinforced,
/turf/open/floor/plasteel/dark,
/area/shuttle/syndicate/medical)
"cc" = (
/obj/item/storage/firstaid/regular{
	pixel_x = 3;
	pixel_y = 3
	},
/obj/item/storage/firstaid/fire,
/obj/item/storage/firstaid/regular{
	pixel_x = -3;
	pixel_y = -3
	},
/obj/structure/table/reinforced,
/turf/open/floor/plasteel/dark,
/area/shuttle/syndicate/medical)
"ce" = (
/obj/item/sbeacondrop/bomb{
	pixel_y = 5
	},
/obj/item/sbeacondrop/bomb,
/obj/structure/table/reinforced,
/turf/open/floor/plasteel/dark,
/area/shuttle/syndicate/armory)
"cf" = (
/obj/item/grenade/syndieminibomb{
	pixel_x = 4;
	pixel_y = 2
	},
/obj/item/grenade/syndieminibomb{
	pixel_x = -1
	},
/obj/structure/table/reinforced,
/obj/structure/window/reinforced{
	dir = 4
	},
/obj/item/grenade/c4,
/obj/item/grenade/c4,
/obj/item/grenade/c4,
/obj/item/grenade/c4,
/obj/item/grenade/c4,
/turf/open/floor/plasteel/dark,
/area/shuttle/syndicate/armory)
"cg" = (
/obj/structure/window/reinforced{
	dir = 1
	},
/turf/open/floor/plasteel/dark,
/area/shuttle/syndicate/armory)
"ch" = (
/obj/machinery/door/window{
	dir = 1;
	name = "Technological Storage";
	req_access_txt = "150"
	},
/turf/open/floor/plasteel/dark,
/area/shuttle/syndicate/armory)
"ci" = (
/obj/structure/window/reinforced{
	dir = 1
	},
/obj/structure/table/reinforced,
/obj/item/aicard,
/turf/open/floor/plasteel/dark,
/area/shuttle/syndicate/armory)
"cj" = (
/obj/item/surgicaldrill,
/obj/item/circular_saw,
/obj/structure/table/reinforced,
/obj/machinery/light{
	dir = 8
	},
/turf/open/floor/plasteel/dark,
/area/shuttle/syndicate/medical)
"ck" = (
/obj/structure/sink{
	dir = 8;
	pixel_x = 11
	},
/obj/structure/mirror{
	pixel_x = 30
	},
/turf/open/floor/plasteel/dark,
/area/shuttle/syndicate/medical)
"cl" = (
/obj/effect/spawner/structure/window/reinforced,
/turf/open/floor/plating,
/area/shuttle/syndicate/hallway)
"cn" = (
/obj/machinery/light{
	dir = 4
	},
/turf/open/floor/plasteel/dark,
/area/shuttle/syndicate/armory)
"co" = (
/obj/item/cautery,
/obj/item/scalpel,
/obj/structure/table/reinforced,
/turf/open/floor/plasteel/dark,
/area/shuttle/syndicate/medical)
"cp" = (
/obj/structure/table/optable,
/obj/item/surgical_drapes,
/turf/open/floor/plasteel/dark,
/area/shuttle/syndicate/medical)
"cq" = (
/obj/item/retractor,
/obj/item/hemostat,
/obj/structure/table/reinforced,
/turf/open/floor/plasteel/dark,
/area/shuttle/syndicate/medical)
"cr" = (
/obj/structure/shuttle/engine/heater,
/obj/structure/window/reinforced{
	dir = 1
	},
/turf/open/floor/plating/airless,
/area/shuttle/syndicate/hallway)
"cs" = (
/obj/machinery/recharge_station,
/turf/open/floor/circuit/red,
/area/shuttle/syndicate/armory)
"ct" = (
/obj/machinery/telecomms/allinone{
	intercept = 1
	},
/turf/open/floor/circuit/red,
/area/shuttle/syndicate/armory)
"cu" = (
/obj/structure/shuttle/engine/heater,
/obj/structure/window/reinforced{
	dir = 1
	},
/turf/open/floor/plating/airless,
/area/shuttle/syndicate/medical)
"cv" = (
/obj/structure/shuttle/engine/propulsion/left,
/turf/open/floor/plating/airless,
/area/shuttle/syndicate/hallway)
"cw" = (
/obj/structure/shuttle/engine/propulsion,
/turf/open/floor/plating/airless,
/area/shuttle/syndicate/hallway)
"cx" = (
/obj/structure/shuttle/engine/propulsion/right,
/turf/open/floor/plating/airless,
/area/shuttle/syndicate/hallway)
"cy" = (
/obj/structure/shuttle/engine/heater,
/obj/structure/window/reinforced{
	dir = 1
	},
/turf/open/floor/plating/airless,
/area/shuttle/syndicate/armory)
"cz" = (
/obj/structure/shuttle/engine/propulsion/left,
/turf/open/floor/plating/airless,
/area/shuttle/syndicate/medical)
"cA" = (
/obj/structure/shuttle/engine/propulsion,
/turf/open/floor/plating/airless,
/area/shuttle/syndicate/medical)
"cB" = (
/obj/structure/shuttle/engine/propulsion/right,
/turf/open/floor/plating/airless,
/area/shuttle/syndicate/medical)
"cE" = (
/obj/structure/shuttle/engine/propulsion/left,
/turf/open/floor/plating/airless,
/area/shuttle/syndicate/armory)
"cF" = (
/obj/structure/shuttle/engine/propulsion,
/turf/open/floor/plating/airless,
/area/shuttle/syndicate/armory)
"cG" = (
/obj/structure/shuttle/engine/propulsion/right,
/turf/open/floor/plating/airless,
/area/shuttle/syndicate/armory)
"dp" = (
/obj/machinery/porta_turret/syndicate/shuttle{
	dir = 10
	},
/turf/closed/wall/r_wall/syndicate,
/area/shuttle/syndicate/armory)
"dK" = (
/obj/effect/turf_decal/bot_red/right,
/obj/structure/rack,
/turf/open/floor/plasteel/dark,
/area/shuttle/syndicate/airlock)
"fO" = (
/obj/effect/turf_decal/tile/bar{
	dir = 8
	},
/obj/effect/turf_decal/siding/thinplating/dark{
	dir = 1
	},
/turf/open/floor/mineral/plastitanium,
/area/shuttle/syndicate/eva)
"gu" = (
/obj/effect/turf_decal/tile/bar{
	dir = 4
	},
/turf/open/floor/mineral/plastitanium,
/area/shuttle/syndicate/eva)
"gX" = (
/obj/machinery/button/door{
	id = "smindicate";
	name = "external door control";
	pixel_y = 26;
	req_access_txt = "150"
	},
/obj/structure/fans/tiny,
/obj/machinery/door/poddoor{
	id = "smindicate";
	name = "outer blast door"
	},
/turf/open/floor/plating,
/area/shuttle/syndicate/airlock)
"kw" = (
/obj/effect/turf_decal/syndicateemblem/middle/middle,
/turf/open/floor/mineral/plastitanium/red,
/area/shuttle/syndicate/hallway)
"kL" = (
/obj/effect/turf_decal/syndicateemblem/bottom/middle,
/turf/open/floor/mineral/plastitanium/red,
/area/shuttle/syndicate/hallway)
"mj" = (
/obj/effect/turf_decal/syndicateemblem/top/right,
/turf/open/floor/mineral/plastitanium/red,
/area/shuttle/syndicate/hallway)
"nE" = (
/obj/effect/turf_decal/siding/thinplating/dark{
	dir = 4
	},
/obj/effect/turf_decal/siding/thinplating/dark{
	dir = 8
	},
/obj/machinery/door/firedoor,
/obj/structure/railing{
	dir = 4
	},
/obj/structure/railing{
	dir = 8
	},
/turf/open/floor/plasteel/elevatorshaft,
/area/shuttle/syndicate/eva)
"of" = (
/obj/machinery/door/airlock/hatch{
	name = "Cockpit";
	req_access_txt = "150"
	},
/turf/open/floor/plasteel/dark,
/area/shuttle/syndicate/bridge)
"oG" = (
/obj/effect/turf_decal/tile/bar/diagonal,
/obj/effect/turf_decal/tile/dark/diagonal{
	dir = 4
	},
/obj/effect/turf_decal/siding/thinplating/dark/end,
/turf/open/floor/circuit/red,
/area/shuttle/syndicate/bridge)
"pd" = (
/obj/machinery/porta_turret/syndicate/shuttle{
	dir = 5
	},
/turf/closed/wall/r_wall/syndicate,
/area/shuttle/syndicate/bridge)
"pS" = (
/obj/machinery/porta_turret/syndicate/shuttle{
	dir = 5
	},
/turf/closed/wall/r_wall/syndicate,
/area/shuttle/syndicate/airlock)
"sA" = (
/obj/machinery/suit_storage_unit/syndicate,
/obj/effect/turf_decal/siding/thinplating/dark{
	dir = 4
	},
/obj/structure/window/reinforced/survival_pod{
	dir = 4
	},
/turf/open/floor/mineral/plastitanium,
/area/shuttle/syndicate/eva)
"vv" = (
/obj/effect/turf_decal/tile/red,
/obj/structure/rack,
/obj/item/storage/toolbox/syndicate,
/obj/item/crowbar/red,
/turf/open/floor/plasteel/dark,
/area/shuttle/syndicate/eva)
"vX" = (
/obj/effect/turf_decal/tile/bar{
	dir = 1
	},
/obj/effect/turf_decal/siding/thinplating/dark,
/turf/open/floor/mineral/plastitanium,
/area/shuttle/syndicate/eva)
"yv" = (
/obj/effect/turf_decal/tile/bar,
/obj/structure/sign/poster/contraband/free_key{
	pixel_y = 32
	},
/turf/open/floor/mineral/plastitanium,
/area/shuttle/syndicate/eva)
"EZ" = (
/obj/effect/turf_decal/tile/bar,
/turf/open/floor/plasteel/dark,
/area/shuttle/syndicate/hallway)
"In" = (
/obj/machinery/porta_turret/syndicate/shuttle{
	dir = 6
	},
/turf/closed/wall/r_wall/syndicate,
/area/shuttle/syndicate/bridge)
"Kg" = (
/obj/effect/turf_decal/siding/thinplating/dark/end,
/turf/open/floor/plasteel/chapel,
/area/shuttle/syndicate/hallway)
"KA" = (
/obj/effect/turf_decal/bot_red/right,
/obj/structure/closet/crate,
/obj/item/clothing/suit/armor/vest/capcarapace/syndicate,
/obj/item/clothing/head/hos/syndicate,
/obj/item/clothing/head/hos/beret/syndicate,
/turf/open/floor/plasteel/dark,
/area/shuttle/syndicate/airlock)
"Lv" = (
/turf/closed/wall/r_wall/syndicate/nodiagonal,
/area/shuttle/syndicate/bridge)
"MJ" = (
/obj/machinery/porta_turret/syndicate/shuttle{
	dir = 6
	},
/turf/closed/wall/r_wall/syndicate,
/area/shuttle/syndicate/medical)
"Om" = (
/obj/machinery/computer/secure_data/syndie{
	dir = 8
	},
/obj/effect/turf_decal/tile/red,
/turf/open/floor/plasteel/dark,
/area/shuttle/syndicate/bridge)
"SO" = (
/obj/machinery/portable_atmospherics/canister/oxygen,
/obj/effect/turf_decal/siding/thinplating/dark{
	dir = 4
	},
/obj/structure/window/reinforced/survival_pod{
	dir = 4
	},
/turf/open/floor/mineral/plastitanium,
/area/shuttle/syndicate/eva)
"TT" = (
/turf/closed/wall/r_wall/syndicate/nodiagonal,
/area/shuttle/syndicate/airlock)
"UL" = (
/obj/effect/turf_decal/syndicateemblem/middle/right,
/turf/open/floor/mineral/plastitanium/red,
/area/shuttle/syndicate/hallway)
"Wp" = (
/obj/effect/turf_decal/syndicateemblem/top/middle,
/turf/open/floor/mineral/plastitanium/red,
/area/shuttle/syndicate/hallway)

(1,1,1) = {"
aa
aa
aa
aa
aa
aa
aa
aa
aa
aa
aa
aa
aa
aG
aJ
aJ
aJ
aJ
aJ
aJ
aJ
aJ
aJ
"}
(2,1,1) = {"
aa
aa
aa
aa
aa
aa
aa
aw
ax
ax
ax
ax
ax
aJ
bq
bC
bq
bR
bY
cj
co
cu
cz
"}
(3,1,1) = {"
aa
aa
aa
aa
aa
aa
aa
ax
aL
ay
bJ
aR
aL
aJ
br
br
br
br
bZ
br
cp
cu
cA
"}
(4,1,1) = {"
aa
aa
aa
aa
aa
aa
aa
ax
yv
vX
aZ
fO
gu
bk
bs
br
br
br
ca
ck
cq
cu
cB
"}
(5,1,1) = {"
ab
ac
ac
ac
ac
aa
aa
ax
SO
aM
aZ
bW
sA
aJ
bt
br
br
br
cb
aK
aJ
aJ
MJ
"}
(6,1,1) = {"
ac
ag
an
at
ac
ad
aa
ax
aN
aS
aU
aZ
vv
aJ
bu
br
br
br
cc
aJ
aa
aa
aa
"}
(7,1,1) = {"
ae
ah
ao
bT
Lv
ac
af
aA
nE
nE
aA
ba
bg
aK
bv
bv
bK
bv
aJ
aJ
af
af
aa
"}
(8,1,1) = {"
ae
ai
bI
au
av
ac
bP
aH
aC
aC
aV
EZ
bS
az
bD
bE
bL
bO
cl
aD
cr
cv
aa
"}
(9,1,1) = {"
ae
aj
aq
oG
av
of
aD
be
Kg
aD
aW
aD
bS
Wp
kw
kL
bL
aD
bo
aD
cr
cw
aa
"}
(10,1,1) = {"
ae
ak
ap
bT
bN
ac
aE
aI
aE
aE
aV
bH
bS
mj
UL
bF
bL
bU
cl
aD
cr
cx
aa
"}
(11,1,1) = {"
ae
al
ar
au
Lv
ac
af
TT
bV
bV
TT
bb
bh
bj
bw
bw
bM
bw
bm
bm
af
af
aa
"}
(12,1,1) = {"
ac
am
as
Om
ac
In
aa
aB
aO
bc
aX
bc
bi
bm
bx
bG
bG
bG
ce
bm
aa
aa
aa
"}
(13,1,1) = {"
pd
ac
ac
ac
ac
aa
aa
aB
aQ
dK
dK
KA
bi
bm
by
bG
bG
bG
cf
bj
bm
bm
dp
"}
(14,1,1) = {"
aa
aa
aa
aa
aa
aa
aa
aB
aQ
aT
aP
aP
bi
bn
bz
bG
bG
bG
cg
bG
cs
cy
cE
"}
(15,1,1) = {"
aa
aa
aa
aa
aa
aa
aa
aB
aQ
bc
bc
bc
bi
bm
bA
bG
bG
bG
ch
bG
ct
cy
cF
"}
(16,1,1) = {"
aa
aa
aa
aa
aa
aa
aa
pS
aB
gX
aY
bd
aB
bm
bB
bG
bQ
bX
ci
cn
cs
cy
cG
"}
(17,1,1) = {"
aa
aa
aa
aa
aa
aa
aa
aa
aa
aa
aa
aa
aa
aF
bm
bm
bm
bm
bm
bm
bm
bm
bm
"}
